11111111111111111111111111111111111111111111111111111111111111111111111111
1CCCCCCCCCCCCCCCCCCCCCCCCCCCCCCCCCCCCCCCCCCCCCCCCCCCCCCCCCCCCCCCCCCCCCCCC1
1C1111111100000000000111111111111100000000111111111111000000111111111111C1
1C1111111100000000000111111111111100000000111111111111000000111111111111C1
1C1111111100000000000111111111111100000000111111111111000000111111111111C1
1C1100001100000000000000000000001100000000000000000011000000110000000011C1
1C11000011000000000000000000G0001100000000000000000011000000110000000011C1
1C0000001100000000000000000000001100000000000000E00011000000110000000011C1
1C0000001100000000000000000000001100000000000000000011000000000000000011C1
1C0000P01100000000000011000000001100000000000000000011000000000000000011C1
1C0000001100000000000011111111111100000000111111111111000000000000000011C1
1C0000001100000000000011111111111100000000111111111111000000000000000011C1
1C0000001100000000000000000000001100000000000000000011000000000000000011C1
1C00000011000000000000000000G0001100000000000000E00011000000000000000011C1
1C0000001100000000000000000000001100000000000000000011000000000000000011C1
1C0000001100000000000000000000001100000000000000000011000000000000000011C1
1C0001111111100000000111111111111100000000111111111111000000000000000001C1
1C0001111111100000000111111111111100000000111111111111000000000000000001C1
1C0001111111100000000111111111111100000000111111111111000000000000000001C1
1CCCCCCCCCCCCCCCCCCCCCCCCCCCCCCCCCCCCCCCCCCCCCCCCCCCCCCCCCCCCCCCCCCCCCCCC1
11111111111111111111111111111111111111111111111111111111111111111111111111