11111111111111111111111111111111111111
1CCCCCCCCCCCCCCCCCCCCCCCCCCCCCCCCCCCC1
1CCCCCCCCCCCC1111111C111111111111111C1
1CCCCCCCCC11111111CCC1111CCC11111111C1
1CCCCCCC1111111CCCCCC1C1CCCC11111111C1
1CCCC11111111CCCCCCCC1CCCCCC1111111CC1
1CC1111111CCCCCCCCCCCCCCC11111111CCCC1
1C111111CCCCCCCCCCCCCCC1111111CCCCCCC1
1C1111CCCCCCCCCCCCCCC1111111CCCCCCCCC1
1C111111111111111111C1111111CCCCC111C1
1C111111111111111111C1111111CCC11111C1
1C111111111111111111C1111111C1111111C1
1CCCCCCCCCCCC1111111CCCCCCCCCCCCCCCCC1
1CCCCCCCCCCCC1111111C11CCCCCCCCCCCCCC1
1CCCCCCCCCCCC1111111C1111111111111CCC1
1PCCCCCCCCCCC1111111CCCCCCCCCCCCCCCCE1
11111111111111111111111111111111111111