11111111111111111111111
1E00C00000C0000001N00G1
100001010010CCC00010101
11010N010010010N0010101
1C00P000000000000000C11
11111111111111111111111