11111111111111111111111
1E00C00000C0000001N0001
100001010010CCC00010101
11010N010010010N0010101
1C00P00000000000000GC11
11111111111111111111111