111111111111111111111111111111111111111111111111111111111
1000CCC00000000000000000000001000000000000C00000000E00001
100000000000C000000000000CCCCCCCCCCC000000000000000000001
100000000011111111111111111111111111111111111111111100001
10000000000000000C00000000000000000000C000000000000000001
100001111000111000011100011100011100000000001110001110001
1111110CC1110CC01110CC1110CC1110C011100001110C01110C01111
10000000000000000000000C000000000000000000000000000000001
1010P1001001001001001001001001001001001001001001001001001
111111111111111111111111111111111111111111111111111111111