1111111111111111111111111111111111
1EPCCCCCCCCCCCCCCCCCCCCCCCCCCCCCC1
111CC1C1CC1CCCCC1C1CC1CCCCCCC1C1C1
1C1CC1CC1C1C1C1CCC1CC1CCCG0CC1C1C1
1C0CCCCCCCCCCCCCCCCCCCCCCCCCCCCCC1
1111111111111111111111111111111111