11111111111111111111111111
1000020000PC000E0000000G01
11111111111111111111111111
