11111111111111111111111111
1000000000PC001E0000000001
11111111111111111111111111
