11111111111111111111111111
1000000000PC010E0000000001
11111111111111111111111111
